{
  "entityMap": [
    [0, 0, 0, 0, 0, 0, 0, 0, 0, 0, 0, 0, 0, 0, 0, 0],
    [0, 0, 0, 3, 0, 0, 0, 0, 0, 0, 0, 0, 0, 0, 0, 0],
    [0, 0, 0, 0, 0, 0, 0, 10, 10, 0, 0, 0, 0, 0, 0, 0],
    [0, 0, 0, 0, 0, 0, 0, 10, 10, 0, 0, 0, 0, 14, 0, 0],
    [0, 1, 0, 0, 0, 0, 0, 0, 0, 0, 0, 0, 0, 12, 24, 0],
    [0, 0, 0, 0, 0, 0, 0, 0, 0, 0, 0, 0, 0, 0, 0, 0],
    [0, 0, 0, 0, 0, 0, 0, 10, 10, 0, 0, 30, 30, 0, 0, 0],
    [0, 2, 0, 10, 10, 0, 0, 0, 0, 0, 0, 0, 0, 0, 10, 0],
    [0, 0, 0, 0, 0, 0, 0, 0, 0, 0, 0, 0, 0, 0, 0, 0]
  ],
  "tileMap": [
    [7, 7, 5, 0, 0, 4, 5, 0, 0, 0, 0, 0, 0, 0, 0, 3],
    [7, 5, 4, 8, 8, 8, 8, 8, 8, 8, 8, 8, 8, 8, 8, 2],
    [5, 4, 8, 8, 8, 8, 8, 8, 8, 8, 8, 8, 8, 8, 8, 2],
    [2, 8, 8, 8, 8, 8, 8, 8, 8, 8, 8, 8, 3, 8, 8, 2],
    [2, 8, 8, 8, 5, 0, 0, 0, 3, 8, 8, 8, 8, 8, 8, 2],
    [1, 0, 0, 0, 4, 8, 8, 8, 2, 8, 8, 8, 8, 8, 8, 2],
    [2, 8, 8, 8, 8, 8, 8, 8, 8, 8, 8, 8, 8, 8, 8, 2],
    [2, 8, 8, 8, 8, 8, 2, 8, 8, 8, 8, 8, 8, 8, 8, 2],
    [2, 6, 0, 0, 0, 0, 1, 0, 0, 0, 0, 0, 0, 0, 0, 4]
  ]
}