{
  "entityMap": [
    [0, 0, 0, 0, 0, 0, 0, 0, 0, 0, 0, 0, 0, 0, 0, 0, 0, 0, 0],
    [0, 15, 15, 15, 15, 25, 0, 0, 0, 0, 0, 23, 0, 0, 0, 0, 2, 0, 0],
    [0, 0, 0, 0, 0, 15, 25, 0, 0, 0, 0, 0, 23, 0, 0, 0, 0, 16, 0],
    [0, 0, 0, 0, 0, 15, 15, 0, 30, 0, 0, 25, 25, 0, 0, 0, 0, 16, 0],
    [0, 0, 0, 0, 0, 0, 15, 0, 0, 0, 0, 0, 25, 0, 0, 0, 0, 25, 0],
    [0, 16, 0, 0, 0, 0, 0, 0, 0, 0, 0, 0, 0, 0, 0, 0, 0, 0, 0],
    [0, 0, 0, 0, 0, 0, 0, 0, 0, 0, 0, 0, 0, 0, 0, 0, 0, 0, 0],
    [0, 0, 0, 0, 0, 0, 0, 0, 0, 0, 0, 21, 21, 0, 0, 0, 0, 0, 0],
    [0, 0, 16, 0, 0, 0, 0, 0, 0, 11, 0, 0, 0, 0, 0, 0, 0, 0, 0],
    [0, 25, 0, 0, 0, 0, 0, 0, 0, 11, 13, 0, 0, 0, 0, 0, 0, 0, 0],
    [0, 25, 0, 0, 0, 0, 0, 0, 0, 11, 0, 0, 0, 0, 0, 0, 3, 1, 0],
    [0, 0, 0, 0, 0, 0, 0, 0, 0, 0, 0, 0, 0, 0, 0, 0, 0, 0, 0]
  ],
  "tileMap": [
    [6, 0, 0, 0, 0, 4, 5, 0, 0, 0, 0, 0, 0, 0, 1, 6, 0, 0, 3],
    [2, 8, 8, 8, 8, 8, 8, 8, 8, 8, 8, 8, 8, 8, 2, 2, 8, 8, 2],
    [2, 8, 8, 8, 8, 8, 8, 2, 8, 8, 8, 8, 8, 8, 2, 2, 8, 8, 2],
    [2, 8, 8, 8, 8, 8, 8, 2, 8, 8, 8, 8, 8, 8, 5, 4, 8, 8, 2],
    [2, 8, 8, 8, 8, 8, 8, 2, 8, 8, 8, 8, 8, 8, 8, 8, 8, 8, 2],
    [1, 8, 8, 8, 8, 8, 6, 1, 0, 0, 0, 0, 0, 0, 0, 0, 0, 0, 1],
    [2, 8, 8, 8, 8, 8, 5, 1, 0, 0, 0, 0, 0, 0, 0, 0, 0, 0, 1],
    [2, 8, 0, 0, 0, 0, 0, 4, 8, 8, 8, 8, 8, 8, 8, 8, 8, 8, 2],
    [2, 8, 8, 8, 8, 8, 8, 8, 8, 8, 8, 8, 8, 8, 8, 8, 8, 8, 2],
    [2, 8, 8, 8, 8, 8, 8, 2, 8, 8, 8, 8, 8, 8, 8, 8, 8, 8, 2],
    [2, 8, 8, 8, 8, 8, 8, 2, 8, 8, 8, 8, 8, 8, 8, 8, 8, 8, 2],
    [2, 6, 0, 0, 0, 0, 0, 1, 0, 0, 0, 0, 0, 0, 0, 0, 0, 0, 4]
  ]
}