{
  "entityMap": [
    [0, 0, 0, 0, 0, 0, 0, 0, 0, 0, 0, 0, 0, 0, 0, 0],
    [0, 0, 0, 0, 0, 0, 0, 0, 0, 0, 0, 0, 0, 0, 0, 0],
    [0, 0, 0, 0, 0, 0, 0, 0, 0, 0, 0, 0, 0, 0, 0, 0],
    [0, 0, 0, 0, 0, 0, 0, 0, 0, 0, 0, 0, 0, 0, 2, 0],
    [0, 1, 0, 0, 0, 0, 0, 14, 0, 0, 0, 0, 0, 0, 0, 0],
    [0, 0, 0, 0, 0, 0, 0, 14, 0, 0, 0, 0, 0, 0, 3, 0],
    [0, 0, 0, 0, 0, 0, 0, 0, 0, 0, 0, 0, 0, 0, 0, 0],
    [0, 0, 0, 0, 0, 14, 0, 0, 0, 0, 0, 0, 0, 10, 10, 0],
    [0, 0, 0, 0, 0, 0, 0, 0, 0, 0, 0, 0, 0, 0, 0, 0]
  ],
  "tileMap": [
    [7, 7, 6, 0, 0, 4, 5, 0, 0, 0, 0, 0, 0, 1, 1, 3],
    [7, 6, 4, 8, 8, 8, 8, 8, 8, 8, 8, 8, 6, 4, 1, 1],
    [6, 4, 8, 8, 8, 8, 8, 8, 8, 8, 8, 6, 4, 6, 4, 2],
    [2, 8, 8, 8, 8, 6, 3, 8, 8, 8, 6, 4, 6, 4, 8, 2],
    [2, 8, 8, 8, 6, 4, 2, 8, 8, 6, 4, 6, 4, 8, 8, 2],
    [1, 8, 8, 6, 4, 6, 4, 8, 6, 4, 6, 4, 8, 8, 8, 2],
    [2, 8, 6, 4, 6, 4, 8, 8, 5, 0, 4, 8, 8, 8, 8, 2],
    [2, 6, 4, 6, 4, 8, 8, 8, 8, 8, 8, 8, 8, 8, 8, 2],
    [5, 1, 0, 1, 0, 0, 0, 0, 0, 0, 0, 0, 0, 0, 0, 4]
  ]
}