{
  "entityMap": [
    [0, 0, 0, 0, 0, 0, 0, 0, 0, 0, 0, 0, 0, 0, 0, 0],
    [0, 0, 0, 3, 0, 0, 0, 0, 0, 0, 0, 0, 0, 0, 0, 0],
    [0, 0, 0, 0, 0, 0, 0, 0, 0, 0, 0, 0, 0, 0, 0, 0],
    [0, 0, 0, 0, 0, 0, 0, 0, 0, 0, 0, 0, 0, 0, 0, 0],
    [0, 1, 0, 0, 0, 0, 11, 0, 14, 0, 0, 0, 0, 0, 2, 0],
    [0, 0, 0, 0, 0, 0, 11, 0, 14, 0, 0, 0, 0, 0, 0, 0],
    [0, 0, 0, 0, 0, 0, 0, 0, 0, 0, 0, 0, 0, 0, 0, 0],
    [0, 10, 10, 10, 10, 0, 0, 0, 0, 0, 0, 0, 0, 0, 0, 0],
    [0, 0, 0, 0, 0, 0, 0, 0, 0, 0, 0, 0, 0, 0, 0, 0]
  ],
  "tileMap": [
    [7, 7, 6, 0, 0, 4, 5, 3, 0, 0, 0, 0, 0, 0, 0, 3],
    [7, 6, 4, 8, 8, 8, 8, 2, 8, 8, 8, 8, 8, 8, 8, 2],
    [6, 4, 8, 8, 8, 8, 8, 2, 8, 8, 8, 8, 8, 8, 8, 2],
    [2, 8, 8, 8, 8, 8, 8, 2, 8, 8, 8, 8, 3, 8, 8, 2],
    [2, 8, 8, 8, 8, 8, 8, 2, 8, 8, 8, 8, 8, 8, 8, 2],
    [2, 8, 8, 8, 8, 8, 8, 2, 8, 8, 8, 8, 8, 8, 8, 2],
    [2, 8, 8, 8, 8, 8, 8, 8, 8, 8, 8, 8, 8, 8, 8, 2],
    [2, 8, 8, 8, 8, 8, 8, 8, 8, 8, 8, 8, 8, 8, 8, 2],
    [2, 6, 0, 0, 0, 0, 0, 0, 0, 0, 0, 0, 0, 0, 0, 4]
  ]
}